0 0 F F 0 0 0 0 0 0 0 0 0 0 0 0 0 0 0 0 0 0 0 0 0 0 0 0 0 0 0 F F F 0 0 0 0 0 0 0
0 0 0 0 0 0 0 F F F 0 0 0 F F F 0 0 0 0 0 0 0 0 0 0 0 0 0 0 F F 0 F F 0 0 0 0 0 0
0 0 0 0 0 0 0 F 0 F 0 0 0 0 0 0 0 0 0 F F F 0 0 0 0 0 0 0 0 0 0 0 0 0 0 0 0 0 0 0
0 0 0 0 0 0 0 0 0 0 0 0 0 0 0 0 0 F F F F 0 0 0 F F F 0 0 0 0 0 0 0 0 0 0 0 0 F F
F F F F 0 0 0 0 0 0 0 0 0 0 0 0 0 0 0 0 0 0 0 0 0 0 0 0 0 F F F F 0 0 0 0 0 0 0 0
0 0 0 0 0 0 0 0 0 0 F F F 0 0 0 0 0 0 0 0 0 0 0 0 0 0 0 0 0 0 0 0 0 0 0 0 0 0 0 0
0 0 0 0 0 0 0 0 0 0 0 0 F F 0 0 0 F F F 0 0 0 0 F F 0 0 0 0 0 0 0 0 0 0 0 F F 0 0
0 0 0 0 F F F F 0 0 0 0 0 0 0 0 0 F 0 F 0 0 0 0 0 0 0 0 0 0 0 0 0 0 0 0 0 0 F F F
0 0 0 0 0 0 0 0 0 0 0 0 0 0 0 0 0 0 0 0 0 0 0 0 0 0 0 0 0 0 0 0 F F F F 0 0 0 0 0
0 0 0 0 0 0 0 0 0 0 0 F F F F 0 0 0 0 0 0 0 0 0 0 F F F F 0 0 0 0 0 0 0 0 0 0 0 0
0 0 0 0 0 0 0 0 0 0 0 0 0 0 F F F 0 0 0 0 0 0 0 0 0 0 0 0 0 0 0 0 0 0 0 0 0 0 0 0
0 0 0 F F F 0 0 0 0 0 0 0 0 0 0 0 0 0 0 0 0 0 F 0 0 0 0 0 F F F 0 0 0 0 0 0 0 0 0
0 0 0 0 F 0 0 0 0 0 0 0 0 0 0 0 0 0 0 0 0 F F F 0 0 0 0 0 0 0 0 0 0 F F 0 0 0 0 0
0 0 0 0 0 0 0 0 0 F F F F 0 0 0 0 0 0 0 0 0 0 0 0 0 0 0 0 0 0 0 0 F F F F 0 0 0 0
0 0 0 0 0 0 0 0 0 0 0 0 0 0 0 0 0 F F 0 0 0 0 0 0 0 0 0 0 0 0 0 0 0 0 0 0 0 0 0 0
0 0 F F F F 0 0 0 0 0 0 0 0 0 0 0 0 F F F F 0 0 0 0 0 0 F F F 0 0 0 0 0 0 0 0 0 0
0 0 0 0 0 0 0 0 E 0 0 0 0 0 0 0 0 0 0 0 0 0 0 0 0 0 0 0 0 0 0 0 0 0 0 0 0 0 0 0 0
F F F F F F F F F F F F F F F F F F F F F F F F F F F F F F F F F F F F F F F F F